##################             
#       # .....  #                 
#       # .      #               
#       # .      #               
#       # .      #
#       #        #
#       ######   #
#        @       #
#    #           #              
#    #  #  ...   #
#    #  #  .     #
#    #  #  .     #
#    #  #  .     #
#       #  .     #
#       #  .     #
#  +    #  .     #
#  .........     #
##################            
                         
                           
                         
                         
