##################             
#       # .....  #                 
#       # .      #               
#       # .      #               
#    #  # .      #               
#    ####        #              
#    # #######   #              
#        @       #
#    #           #              
#    #  #        #              
#    #  #        #           
#    #  #        #             
#    #  #        #             
#       ##    ####             
#       #        #            
#  +    #        #           
#                #           
##################            
                         
                           
                         
                         
